{
    "name": "Basic Open Arena",
    "group": "Basic Branching",
    "grid": [
        "000000000",
        "011111110",
        "0111111G0",
        "011111100",
        "0S1111110",
        "011111110",
        "011111110",
        "011111110",
        "000000000"
    ]
}